@.................x...........
.......................x......
...........>..................
......x......x.....>..........
................>..........>>.
####.######.#####.............
#xxx.xxx###.#####..xxxxx......
#xxx........#####xxx...x......
#xxxxxxx###..........o.x......
#################xxx...x...>..
...................xxxxx......
L