@..########################
##...........##############
##.#########..#############
...>...>...##..############
#####.##.#####.......######
#####.##...###.#####......#
#####.####.###.#####x####.#
#####...>..###.#......x.#.#
#...>.####.###.#.####.o.#.#
#.########..##..>####.....#
#.#########..###.######.###
#.....x..........######.###
#######################.###
L